anh yêu em|i love you|i love u|wo ai ni|ngộ ái nị|tiamo|sa-rang-hae-oh
ai nói|ai bảo|ai nhủ
ân đức|ân huệ|ơn đức|ân nghĩa|ơn nghĩa|ân tình|ơn tình|ơn huệ
ẩm mốc|ẩm ướt|ướt át|ẩm thấp
ác độc|ác đức|ác hiểm|ác nghiệt|bạo ngược|bạo tàn|bất lương|cay nghiệt|độc ác|hung ác|hung bạo|hung dữ|hung tàn|tàn bạo|tàn ác
bạn bè|bằng hữu|bè bạn|đồng chí|đồng minh
đang bận|đang mắc|đang có việc
bận rộn|bận bịu
bình thường|tầm thường|thông thường|đơn giản|giản đơn
bình tĩnh|an tĩnh|điềm tĩnh|thong thả|thư thả|từ tốn
bình an|yên ổn|an bình|an toàn
bình dân|dân dã
bi thảm|bi thương|thảm thương|bi ai|bi đát|bi lụy|âu sầu|thảm não|não ruột|sầu lòng|sầu tư|não nề|não nùng|u sầu|thê lương|ưu phiền
buồn bực|buồn phiền|buồn chán|phiền muộn|buồn rầu|phiền não|buồn bã
buồn tẻ|buồn tênh|buồn rười rượi|buồn thiu|chán ngắt|tẻ nhạt
bi quan|tuyệt vọng|vô vọng|sầu thảm
bị động|thụ động
buồn tình|thất tình|sầu thương|sầu lòng
bí mật|secret|tuyệt mật
ba hoa|bịa đặt|bịa chuyện|nói sảng|bóp méo sự thật|đặt điều|dói dối|nói điêu|nói khoác|bốc phét|nói láo|nói trạng|trạng lồi|nói xạo|dối lừa|lừa dối|lừa đảo|khoác lác
bừa bãi|bừa bộn|lộn xộn
bạc tình|bạc bẽo|bạc nghĩa|bội bạc|tệ bạc|vô ơn|phụ bạc
bất công|thiên vị|không công bằng|ko công bằng
bây giờ|hiện tại
bè đảng|bè pháp|bè lũ
bé xíu|bé tí|nhỏ bé|nhỏ nhặt|tí hon|vụn vặt|nhỏ nhoi|tí xíu|vụn vặt
bậy bạ|nhăng nhít|tầm bậy|tầm phào|nhảm nhí|càn rỡ
bỏ nhau|li dị|ly hôn|đường ai nấy đi|chia tay
bỏ bê|bỏ mặc|mặc kệ|không ngó ngàng|ko để tâm
cái ni|cái này
ca ngợi|khen ngợi|khen thưởng
chuyện ni|chuyện này
cẩu thả|chây lười|lười nhác|biếng nhác|làm biếng|chểnh mảng|nhác nhớm|qua loa|qua quýt
chăm chỉ|cần mẫn|cần cù|chăm làm|chăm học|siêng năng|chuyên cần
cao thượng|cao đẹp|cao cả|cao đạo
cao quý|cao sang|thượng đẳng
cao thâm|cao tay|cao siêu
cái chi|cái gì|cái nào|cái giề
cách chi|cách gì|cách nào
cách biệt|cách ngăn|cách chia|ngăn cách|cách trở|cách xa|xa cách|chia lìa|chia xa|xa nhau
cây viết|cây bút
có khỏe|có ổn|có tốt|có ok
con người|nhân loại|loài người
của cải|tài sản|tiền|tiền bạc|vàng bạc|bạc vàng
cũng không|cũng ko|cũng chẳng
chớp mắt|nháy mắt
chê bai|chê cười|cười chê|gièm pha|nói xấu|phê bình
chửi bới|chửi mắng|chửi rủa|trách móc|mắng mỏ|trách mắng|mắng chửi|chửi|mắng
chung thuỷ|chung tình|thủy chung
chậm chạp|chậm rãi|chậm trễ
cẩn thận|thận trọng|kỹ càng|kỹ tính|cẩn mật|cẩn trọng
cầu xin|năn nỉ
chết|hy sinh|bỏ mạng|die|quyên sinh|băng hà|chầu trời|chầu hà bá|chầu phật|chầu chúa|quy tiên|tạ thế|ra đi|tịch diệt|toi mạng|chết toi|viên tịch|yên nghỉ ngàn thu
công bằng|công bình|vô tư|phóng khoáng
cô độc|cô đơn|đơn côi|đơn độc|lẻ loi|một mình
cao ngất|cao vút|cao lêu nghêu|cao ráo
cộng đồng|tập thể|bầy đàn
chắc chắn|xác định|rõ ràng
chặt chẽ|nghiêm ngặt
chú ý|chú tâm|để tâm|để ý|để mắt
chăm chút|chăm bón|chăm nom|ngó ngàng|săn sóc|trông nom
đảm đang| dam dang
dễ thương|đáng yêu|cute|kawaii|đáng iu|ngoan hiền|xinh xắn
dơ bẩn|bẩn thỉu|nhớp|nhơ bẩn|kinh tởm|tởm
dơ như|bẩn như|nhớp như
dùng|sử dụng|xài
dãn nở|nở nang|dãn ra|phình ra
đầy ắp|đầy tràn|tràn ngập|tràn trề|đầy rẫy|tràn đầy
đơn giản|giản đơn|rõ ràng|dễ dàng|easy
địa ngục|âm phủ|âm ti
đi nhanh|đi mau
đa số|phần lớn|số nhiều|số đông|phần nhiều|phần đông|chủ yếu
dũng cảm|gan dạ|can đảm|anh dũng|bạo gan|gan góc|gan lì|liều lĩnh
đào tạo|giáo dục|dạy bảo|giảng dạy|chỉ dạy|dạy dỗ
đầu hàng|chịu thua|từ bỏ|bỏ cuộc|buông bỏ|buông tha
đúng|chính xác|không sai|chuẩn
đó|kia|đấy
đòi hỏi|yêu cầu|đòi|muốn
đối xử|đối đãi|cư xử
đền bù|bù tiền|bù lỗ
gọn gàng|gọn nghĩ|gọn nhẹ|ngăn nắp
giữ gìn|cất giữ
giam cầm|giam giữ|nhốt
hôm qua|hôm trước|hôm kia|hôm đó
hóng|trông chờ|chờ|chờ đợi
hòa bình|yên bình|bình yên|an bình
hèn nhát|nhát gan|bạc nhược|rụt rè|e lệ
hờ hững|lạnh lùng|lạnh nhạt|nhạt nhẽo|tẻ nhạt|thờ ơ
hiền đức|hiền hậu|hiền hòa|hiền lành|hiền lương|hiền khô|nhân hậu|nhân nghĩa|thánh thiện|thiện tâm|nhân từ
hoảng loạn|hoảng sợ|sợ hãi|lo sốt vó|lo lắng|lo ngại|sốt ruột|bối rối|hoảng hồn|hoảng hốt|hồi hộp|lúng túng|thấp thỏm
haha|hehe|hì hì|hiehie|hie hie|hờ hờ|hí hí|hoho|kaka|ha ha|he he|hh
huhu|hichic|hic hic|hiz|T_T
hạ đẳng|thấp kém
hèn hạ|hèn kém|hèn mạt|hèn mọn
ích kỷ|thờ ơ|lạnh nhạt|ko quan tâm ai cả|vô tâm|vô tình|máu lạnh|lãnh khốc
im lặng|im re|lặng im|im thít|im thin thít|im như thóc
không|ko 
kẻ thù|địch thủ|kẻ địch|thù địch|tình địch|cừu địch
không nói|chẳng nói|không bảo|không nhủ
khẩu nghiệp|nói lời cay đắng|cà khịa
khó khăn|phức tạp|phiền phức|phiền toái|bất tiện
khô nóng|khô hanh|khô nẻ|hanh khô|nóng nực|nắng nóng
khổng lồ|to lớn|đồ sộ
kiên trì|bền bỉ|nhẫn nại
kín đáo|không công khai|riêng tư
khác lạ|khác thường|kỳ cục|kì cục|kì dị|kỳ dị|kì quặc|kỳ quặc|kì lạ|kỳ lạ|dị thường|lạ lùng|quái lạ|ko bình thường|bất bình thường|bất thường|lạ lùng|ngược đời
kết duyên|kết hôn
là như vậy|là như thế|là vậy|là thế 
là gì|là cái gì|là thứ gì
làm sao|làm gì|làm thế nào|làm cách gì|làm cái gì
làm ẩu|làm càn|làm bừa|làm liều
lớn lên|lớn khôn|trưởng thành
lúc bé|lúc nhỏ|lúc còn bé|lúc còn nhỏ|lúc nhỏ tuổi|lúc nhỏ dại
loại bỏ|đào thải|thải trừ|vứt
lỏng lẻo|lơi lỏng|buông lỏng|buông lơi
mô |đâu |mok 
mô.|đâu.
mập mạp|mập ú|mapdjt|béo múp|béo tròn
mê hồn|mê ly|mê li
mừng rỡ|mừng quýnh|hí hững|hoan hỷ|mừng rơn|mừng thầm|sung sướng|sướng rơn
mau lẹ|nhanh nhẹn
nhanh chóng|khẩn trương|hối hả|tất bật
này nè|này này
ngày qua|ngày trước|ngày kia|ngày đó
nhà thơ|thi sĩ
nguy cấp|nguy hại|nguy hiểm|nguy khốn|nguy nan|nguy ngập
nước ngoài|ngoại quốc
nghĩa vụ|nhiệm vụ
nhấp nhô|gập ghềnh|lồi lõm
người lớn|người trưởng thành
nhảy cẫng|nhảy cà tưng
nhây|giỡn|đùa
nhìn|ngó|nhòm
nhỏ con|nhỏ xác|ốm yếu|gầy gò|gầy dơ xương|gầy yếu|gầy còm
nôn nóng|nóng vội|vội vã|vội vàng
piano|pi-a-no|dương cầm
phản động|phản cách mạng
phần ít|thiểu số|số ít|số nhỏ|phần nhỏ
phía bắc|hướng bắc
phía nam|hướng nam
phía đông|hướng đông
phía tây|hướng tây
phi pháp|trái pháp luật
phấn khởi|phấn chấn|phấn khích
phải không nè|phải không này|phải không nhỉ|phải không|đúng không|đúng không này|đúng không nè|đúng không nhỉ
quạu|quạo|cáu|tức|giận
qq|quần què|nani|nà ní
rứa|ruk|thế
riêng biệt|đơn lẻ
rườm rà|rắc rối|xoắn não|hại não
rãnh rỗi|thảnh thơi|nhàn nhã|nhàn rỗi|thư thả
rất thê thảm|rất tội nghiệp
sum họp|sum vầy|đoàn tụ
thì thôi|thì mặc kệ|thì không quan tâm|thì đừng quan tâm|thì đừng bận tâm|thì kệ|thì bỏ qua
thông minh|giỏi|khôn ngoan|sâu sắc|trí tuệ
ti vi|tivi|TV
thay mặt|đại diện
tài giỏi|tài hoa|kiệt xuất|xuất sắc|giỏi giang|tài tình|xuất chúng|tài ba
thì thầm|thầm thì|thủ thỉ
thiên thần|angel|nhân thần|địa thần|thần tiên
thành quả|thành tích|kết quả
trực thăng|máy bay|phi cơ
tổng thể|toàn bộ|toàn diện|toàn phần|toàn vẹn|trọn vẹn
tổn thương|đau đớn|đau trong lòng|đau tim|đau con tym|đau lòng
thê thảm|thảm thương
thật thê thảm|thật tội nghiệp
tàu hỏa|xe lửa
tập tin|file
tuyệt vời|tuyệt diệu|tuyệt cú mèo|tuyệt mĩ|tuyệt mỹ|tuyệt trần|tuyệt xảo
tiếp nối|thông suốt|nối liền
trẻ em|con nít|trẻ con|bọn nhỏ|bọn trẻ|tụi nhỏ
tiện lợi|thuận tiện
to con|to xác|lớn tướng
trang trọng|trang nghiêm|long trọng
vậy thì|vậy là|thế thì|ruk thì|thế là|ruk là
vui vẻ|hạnh phúc|vui sướng|tươi cười|vui|vui thích|vui mừng|thích thú
vẻ ngoài|bề ngoài|hình thức
nóng vội|vội vã|vội vàng|vội
xe hơi|ô tô
xẹp lép|teo tóp|móp méo|hóp hép
xấu xa|tồi tệ
yếu đuối|yếu ớt|yếu xìu
ý trời|thiên ý|mệnh trời